Adele - Rolling in the Deep
Akon - Right Now (Na Na Na)
Alan Walker - Faded
Alec Benjamin - Let Me Down Slowly
Asher Monroe - Here With You
Ava Max - Salt
Avicii - The Nights
Avicii - Waiting For Love
Backstreet Boys - As Long as You Love Me
Blue - All Rise
Bon Jovi - It's My Life
Bruno Mars - Talking to the Moon
Cascada - Everytime We Touch
Céline Dion - My Heart Will Go On - Love Theme from "Titanic"
The Chainsmokers - Something Just Like This
Charlie Puth - We Don't Talk Anymore (feat. Selena Gomez)
Clarissa Höbel - Dream It Possible
Coldplay - Hymn for the Weekend
Darin - Be What You Wanna Be
Eagles - Hotel California
Ed Sheeran - Shape of You
Fall Out Boy - The Phoenix
Five - We Will Rock You
Flo Rida - Whistle
Groove Coverage - Far Away from Home
Hawk Nelson - Sold Out
Hillsong Young & Free - Wake (Studio)
Imagine Dragons - Believer
Imagine Dragons - Natural
James Blunt - You're Beautiful
Josh Groban - You Raise Me Up
Kelly Clarkson - Stronger (What Doesn't Kill You)
Kim Taylor - I Am You
Lady Gaga - Poker Face
League of Legends - Legends Never Die
League of Legends - RISE
Linkin Park - In the End
Linkin Park - New Divide
Linkin Park - Numb
Luis Fonsi - Despacito
M2M - The Day You Went Away
Mark Ronson - Uptown Funk (feat. Bruno Mars)
Maroon 5 - Sugar
Michael Jackson - Smooth Criminal - 2012 Remaster
Michael Learns To Rock - Take Me to Your Heart
Mono Inc. - Children of the Dark
Nanne - Håll om mig
Naughty Boy - La La La
Nightwish - Bye Bye Beautiful
Nightwish - I Want My Tears Back
Olly Murs - That Girl
One Direction - What Makes You Beautiful
OneRepublic - Counting Stars
Owl City - Good Time
P!nk - Try
Rachel Platten - Lone Ranger
Richard Marx - Right Here Waiting
Rick Astley - Never Gonna Give You Up
Rihanna - Umbrella
Sasha Alex Sloan - Dancing With Your Ghost
The Script - Hall of Fame
Shawn Mendes - Señorita
Sia - Move Your Body - Alan Walker Remix
Taylor Swift - Love Story
Timbaland - Apologize
Tones And I - Dance Monkey
USHER - DJ Got Us Fallin' In Love (feat. Pitbull)
Westlife - My Love
Wiz Khalifa - See You Again (feat. Charlie Puth)
Zedd - Beautiful Now